
##############  
#S# # #      #
# ##  #  #   #
# #      #   #
#    ##  #  E#
##############